"################",
"#      #       #",
"#  ### # ##### #",
"#  #     #     #",
"####### ### ###3",
"#     #        #",
"# ### #######  #",
"#     #   #    #",
"# ##### # ######",
"#       #      #",
"################"