"################",
"#              #",
"#              #",
"#              #",
"#              #",
"#              #",
"#  ##########  #",
"#              #",
"#              #",
"#              #",
"#     5555     #",
"#              #",
"#     55       #",
"#     55       #",
"#              #",
"################"