"################",
"#11  111111  11#",
"#1            1#",
"#1  ########  1#",
"#1  #      #  1#",
"#1  #  3   #  1#",
"#1  #      #  1#",
"#1  ########  1#",
"#1            1#",
"#1  1111111  11#",
"################"